111111111111111111111
100000000000000100001
100000000010011100001
100000000010100000001
100000011110000001001
111111110000000001001
1000001001000000011C1
10000000P100C00011111
100000100111100000E01
111111111111111111111