11111111111111111111111111111111
100000000000000000C0000000000001
10000C00000000000000000000000001
10000000000000000000000P00000001
10000000000000000000000000000001
111C11100000000000C0000000000001
10000010000000000000000000000001
100C0010000000001000000000000001
100000100000000CE100000000000001
11111111111111111111111111111111
