11111111111111111111111111111111
100000000000000000C0000000000001
10000C00000000000000000000000001
10000000000000000000000P00000001
10000000000000000000000000000001
111111100000000000C0000000000001
10000010000000000000000000000001
10C00000000000001000000000000001
1000001000000000E100000000000001
11111111111111111111111111111111
