111111111111111111111
100000000000000100001
100000000011011100001
100000000010000000001
100000011111000001001
111111110000000001001
100000100100000001001
10000000P0000C0011001
1000001001111000E1001
111111111111111111111
