111111111111111111111
100000000000000000C01
10000C000000000000001
10000000P000000000001
100000000000000000001
111111100000000000C01
100000100000000000001
10C000000000000010001
1000001000000000E1001
111111111111111111111
