1111111111111111111111111111111111
100C00000000P0000000000000000000E1
1011000000000000000000000000010001
1C11000000000000000000000000011101
1011000000000000000000000000010001
1C11000000000000000000000000011101
1011000000000000000000000000010001
1C11000000000000000000000000011101
1011000000000000000C00000000001001
1C11000000000000000000000000011101
1011000000000000000000000000010001
1C11000000000000000000000000011101
1011000000000000000000000000010001
1011000000000000000000000000010001
1011000000000000000000000000010001
1111111111111111111111111111111111